111111111111111111111111111111
111P10111111111111111111111111
10CECCC11111111111111111111111
111CC0111111111111001111111111
1C01C1011111111111111111111111
1CCCC1111111111111111111111111
1CC111111111111111111111111111
1CCCC1111111111111111111111111
111111111111111111111111111111