111111111111111111111111111111111111
1111000000000C0000000001111111111111
11110111111111001111110000000C111011
100001111111100011111111111100000011
11110011C110000111011111111111111111
111111CPE000101111111111001111111011
111111111111111111111111111111111111